"a" = (/turf/template_noop,/area/template_noop)
"b" = (/turf/template_noop,/area/submap/outpost21/asteroid_generic)
"c" = (/obj/structure/lattice,/turf/space,/area/submap/outpost21/asteroid_generic)
"d" = (/turf/simulated/mineral/vacuum,/area/submap/outpost21/asteroid_generic)
"e" = (/turf/simulated/mineral/floor/vacuum,/area/submap/outpost21/asteroid_generic)
"L" = (/turf/space,/area/submap/outpost21/asteroid_generic)

(1,1,1) = {"
aaaaaaaaaaaaaaaaaaaaaaaaaaaaaaaaaaaaaaaaaaaaaaaaaaaaaaaaaaaaaaaaaaaaaaaaaaaaaaaa
abbbbbbbbbbbbbbbbbbbbbbbbbbbbbbbbbbbbbbbbbbbbbbbbbbbbbbbbbbbbbbbbbbbbbbbbbbbbbba
abbbbbbbbbbbbbbbbbbcbbbbbbbbbbbbcbbbbbbbbbbbbbbbbbbbbbbbbbbbbbbbbbbbbbbbbbbbbbba
abbbbbbbbbbbbbLddccccdbcccLbbbbbcbbbbbbbbbbbcbbbbbbbbbbbbbbbbbbbbbbbbbbbbbbbbbba
abbbbbbbbbbcLddddddcddddddddccccccddddbbbbbbcbbbbbbbbbbbbbbbbbbbbbbbbbbbbbbbbbba
abbbbbbbbbbcddddddddddddddddddddcddddddddbbbccLddddddbbbbbbbbbbbbbbbbbbbbbbbbbba
abbbbbbbbbbcdddddddddddddddddddddddddddddccccddddddddddbbbbbbbbbbbbbbbbbbbbbbbba
abbbbbbcbbLddddddddddddddddddddddddddddddddddddddddddddbcbbbbbbbbbbbbbbbbbbbbbba
abbbbcccbLddddddddddddddddddddddddddddddddddddddddddddddcbcbbbbbbbbbbbbbbbbbbbba
abbbbbdcLLddddddddddddddddddddddddddddddddddddddddddddddccccccccbbbcbbbbbbbbbbba
abbbbbddcccdddddddddddddddddddddddddddddddddddddddddddddddcLLLdddbbcbbbbbbbbbbba
abbbbddddLddddddddddddddddddddddddddddddddddddddddddddddddddddddddbcbbbcbbbbbbba
abbbbdddddddddddddddddddddddddddddddddddddddddddddddddddddddddddddcccccccccbbbba
abbbcddddddddddddddddddddddddddddddddddddddddddddddddddddddddddddddddLbcbbbbbbba
abbbcddddddddddddddddddddddddddddddddddddddddddddddddddddddddddddddddLbbbbbbbbba
abbbddddddddddddddddddddddddddddddddddddddddddddddddddddddddddddddddddbbbbbbbbba
abbccdddddddddddddddddddddddddddddddddddddddddddddddddddddddddddddddddbbbbbbbbba
abcLcddddddddddddddddddedddddddddddddddddddddddddddddddddddddddddddddddbbbbbbbba
abcccdddddddddddddddddeeeedddddddddddddddddddddddddddddddddddddddddddddcbbbbbbba
abLLddddddddddddddddeeeeeeeedddddddddddddddddddddddddddddddddddddddddddccbbcbbba
abbLddddddddddddddeeeLLLLLeeeddddddddddddddddddddddddddddddddddddddddddddbbcbbba
abbbdddddddddddddeeLLLLLLLeeedddddddddddddddddddddddddddddddddddddddddddddbcbbba
abbbddddddddddddeeLLLLeeeeeedddddddddddddddddddddddddLddddddddddddddddddddbcbbba
abbbddddddddddddeeLLeeeeeedddddddddddddddddddddddddddLddddddddddddddddddddccccba
abcccdddddddddddeeeeeddddddddddddddddddddddddddddddddLdddddddddddddddddddddcbbba
abbLcddddddddddddeedddddddddddddddddddddddddddddddddeeLddddddddddddddddddddcbbba
abbLcddddddddddddddddddddddddddddddddddddddddddddddddeLLdddddddddddddddddddcbbba
abbLdddddddddddddddddddddddddddddddddddddddddddddddddeLLddddddddddddddddddddbbba
abbLdddddddddddddddddddddddddddddddddddddddddddddddddeeLLdddddddddddddddddddcbba
abbLdddddddddddddddddddddddddddddddddddddddddddddddddeeLeeddddddddddddddddddcbba
abbbddddddddddddddddddddddddddddddddddddddddddddddddddeeLeedddddddddddddddddcbba
abbbLdddddddddddddddddddddddddddddddddddddddddddddddddeeLLeddddddddddddddddddbba
abccccdddddddddddddddddddddddddddddddddddddddddddddddddddLeeddddddddddddddddddba
abbbbLcddddddddddddddddddddddddddddddddddddddddddddddddddLLdddddddddddddddddddba
abbbbbcdddddddddddddddddddddddddddddddddddddddddddddddddddLdddddddddddddddddddba
abbbccccddddddddddddddddddddddddddddddddddddddddddddddddddLdddddddddddddddddddba
abbbbbcbLddddddddddddddddddddddddddeeddddddddddddddddddddddddddddddddddddddddLba
abbbbbcbbcdddddddddddddddddddddddddeeeeeeddddddddddddddddddddddddddddddddddddcba
abbbbbbbbcddddddddddddddddddddddddddeeeeeedddddddddddddddddddddddddddddddddddbba
abbbbbbbbcddddddddddddddddddddddddddeeLLLeedddddddddddddddddddddddddddddddddcbba
abbbbbbbbcLdddddddddddddddddddddddddeeLLLLedddddddddddddddddddddddddddddddddcbba
abbbbbbbbcLLLLddddddddddddddddddddddddeLLeeddddddddddddddddddddddddddddddddLcbba
abbbbbbbcccccccdddddddddddddddddddddddeeLLeddddddddddddddddddddddddddddddddccbba
abbbbbbbbcLLLcddddddddddddddddddddddddeeeeeddddddddddddddddddddddddddddddddcccba
abbbbbbbbcLLLcLdddddddddddddddddddddddeeeeeedddddddddddddddddddddddddddddddbcbba
abbbbbbbbcLLLcLdddddddddddddddddddddddddeeeeeddddddddddddddddddddddddddddddbcbba
abbbbbbbbcLLLcLLLLddddddddddddddddddddddeeeeedddddddddddddddddddddddddddddbbbbba
abbbbbbbccLLLLLLLLcdddddddddddddddddddddeeeeedddddddddddddddddddddddddddddbbbbba
abbbbbbbbccccccccccdddddddddddddddddddddddeeedddddddddddddddddddddddddddddbbbbba
abbbbbbbbbbbcLLcLLcdddddddddddddddddddddddeeedddddddddddddddddddddddddddddccbbba
abbbbbbbbbbbcLLcLLdddddddddddddddddddddddddeedddddddddddddddddddddddddddddccccba
abbbbbbbbbbbcLLddddddddddddddddddddddddddddeedddddddddddddddddddddddddddddcLbbba
abbbbbbbbbbbcLLddddddddddddddddddddddddddddeeddddddddddddddddddddddddddddddLbbba
abbbbbbbbbbbcLLddddddddddddddddddddddddddddeeddddddddddddddddddddddddddddddcbbba
abbbbbbcbbbLcLLdddddddddddddddddddddddddddddeddddddddddddddddddddddddddddddcccca
abbbbbbcbbbLcdddddddddddddddddddddddddddddddedddddddddddddddddddddddddddddddLbba
abbbbccccccccdddddddddddddddddddddddddddddddedddddddddddddddddddddddddddddddLbba
abbbccccccccdddddddddddddddddddddddddddddddddddddddddddddddddddddddddddddddddbba
abbbbbbcLLLddddddddddddddddddddddddddddddddddddddddddddddddddddddddddddddddddbba
abbbbbbcLLLddddddddddddddddddddddddddddddddddddddddddddddddddddddddddddddddcccba
abbbbbbcLLdddddddddddddddddddddddddddddddddddddddddddddddddddddddddddddddddcbbba
abbbbbbcLLdddddddddddddddddddddddddddddddddddddddddddddddddddddddddddddddddcbbba
abbbbcccccdddddddddddddddddddddddddddddddddddddddddddddddddddddddddddddddddbbbba
abbbbbbbbbddddddddddddddddddddddddddddddddddddddeeddddddddddddddddddddddddcbbbba
abbbbbbbbbLddddddddddddddddddddddddddddddddddddddeeeeeddddddddddddddddddddcbbbba
abbbbbbbbbbLddddddddddddddddddddddddddddddddddddddeLLedddddddddddddddddddLbbbbba
abbbbbbbbbccddddddddddddddddddddddddddddddddddddddeeLLeedddddddddddddddcccccbbba
abbbbbbbbbbcdddddddddddddddddddddddddddddddddddddddeLLLeddddddddddddddLLcbbbbbba
abbbbbbbcccccdddddddddddddddddddddddddddddddddddddddeeeeeddddddddddddcLbbbbbbbba
abbbbbbbbbbcbLLLdddddddddddddddddddddddddddddddddddddddeeedddddddddddcLbbbbbbbba
abbbbbbbbbbcbbbLLcddddddddddcddddddddddddddddddddddddddeeedddddddddddccccbbbbbba
abbbbbbbbbbbbbbbccccccLLLccccccddddddddddddddddddddddddddddddddddddddcbbbbbbbbba
abbbbbbbbbbbbbbbbcbbbbbbbcLLcLLLLLcccLddddddddddddddddddddddddddddddLcbbbbbbbbba
abbbbbbbbbbbbbbbbcbbbbbbbcbbcbbbbbbbcccccccdddddddddddddddddddddddddLcbbbbbbbbba
abbbbbbbbbbbbbbbbcbbbbbbbbbbcbbbbbbbcbbbbcbbdddddcddddddddddddccccdbbcbbbbbbbbba
abbbbbbbbbbbbbbbbcbbbbbbbbbbbbbbbbbbcbbbbcbbbbddcccccddddddbbbbcbbbbbcbbbbbbbbba
abbbbbbbbbbbbbbbbbbbbbbbbbbbbbbbbbbbbbbbbcbbbbbbbcbbcbbbbbbbbbbbbbbbbbbbbbbbbbba
abbbbbbbbbbbbbbbbbbbbbbbbbbbbbbbbbbbbbbbbbbbbbbbbcbbbbbbbbbbbbbbbbbbbbbbbbbbbbba
abbbbbbbbbbbbbbbbbbbbbbbbbbbbbbbbbbbbbbbbbbbbbbbbbbbbbbbbbbbbbbbbbbbbbbbbbbbbbba
aaaaaaaaaaaaaaaaaaaaaaaaaaaaaaaaaaaaaaaaaaaaaaaaaaaaaaaaaaaaaaaaaaaaaaaaaaaaaaaa
"}
