"a" = (/turf/template_noop,/area/template_noop)
"b" = (/turf/template_noop,/area/submap/outpost21/asteroid_generic)
"c" = (/obj/structure/lattice,/turf/template_noop,/area/submap/outpost21/asteroid_generic)
"d" = (/turf/simulated/mineral/vacuum,/area/submap/outpost21/asteroid_generic)
"e" = (/turf/simulated/mineral/floor/vacuum,/area/submap/outpost21/asteroid_generic)

(1,1,1) = {"
aaaaaaaaaaaaaaaaaaaaaaaaaaaaaaaaaaaaaaaaaaaaaaaaaaaaaaaaaaaaaaaaaaaaaaaaaaaaaaaa
abbbbbbbbbbbbbbbbbbbbbbbbbbbbbbbbbbbbbbbbbbbbbbbbbbbbbbbbbbbbbbbbbbbbbbbbbbbbbba
abbbbbbbbbbbbbbbbbbcbbbbbbbbbbbbcbbbbbbbbbbbbbbbbbbbbbbbbbbbbbbbbbbbbbbbbbbbbbba
abbbbbbbbbbbbbbddccccdbcccbbbbbbcbbbbbbbbbbbcbbbbbbbbbbbbbbbbbbbbbbbbbbbbbbbbbba
abbbbbbbbbbcbddddddcddddddddccccccddddbbbbbbcbbbbbbbbbbbbbbbbbbbbbbbbbbbbbbbbbba
abbbbbbbbbbcddddddddddddddddddddcddddddddbbbccbddddddbbbbbbbbbbbbbbbbbbbbbbbbbba
abbbbbbbbbbcdddddddddddddddddddddddddddddccccddddddddddbbbbbbbbbbbbbbbbbbbbbbbba
abbbbbbcbbbddddddddddddddddddddddddddddddddddddddddddddbcbbbbbbbbbbbbbbbbbbbbbba
abbbbcccbbddddddddddddddddddddddddddddddddddddddddddddddcbcbbbbbbbbbbbbbbbbbbbba
abbbbbdcbbddddddddddddddddddddddddddddddddddddddddddddddccccccccbbbcbbbbbbbbbbba
abbbbbddcccdddddddddddddddddddddddddddddddddddddddddddddddcbbbdddbbcbbbbbbbbbbba
abbbbddddbddddddddddddddddddddddddddddddddddddddddddddddddddddddddbcbbbcbbbbbbba
abbbbdddddddddddddddddddddddddddddddddddddddddddddddddddddddddddddccccccccbbbbba
abbbcddddddddddddddddddddddddddddddddddddddddddddddddddddddddddddddddbbcbbbbbbba
abbbcddddddddddddddddddddddddddddddddddddddddddddddddddddddddddddddddbbbbbbbbbba
abbbddddddddddddddddddddddddddddddddddddddddddddddddddddddddddddddddddbbbbbbbbba
abbccdddddddddddddddddddddddddddddddddddddddddddddddddddddddddddddddddbbbbbbbbba
abbbcddddddddddddddddddedddddddddddddddddddddddddddddddddddddddddddddddbbbbbbbba
abcccdddddddddddddddddeeeedddddddddddddddddddddddddddddddddddddddddddddcbbbbbbba
abbbddddddddddddddddeeeeeeeedddddddddddddddddddddddddddddddddddddddddddccbbcbbba
abbbddddddddddddddeeebbbbbeeeddddddddddddddddddddddddddddddddddddddddddddbbcbbba
abbbdddddddddddddeebbbbbbbeeedddddddddddddddddddddddddddddddddddddddddddddbcbbba
abbbddddddddddddeebbbbeeeeeedddddddddddddddddddddddddbddddddddddddddddddddbcbbba
abbbddddddddddddeebbeeeeeedddddddddddddddddddddddddddbddddddddddddddddddddccccba
abcccdddddddddddeeeeeddddddddddddddddddddddddddddddddbdddddddddddddddddddddcbbba
abbbcddddddddddddeedddddddddddddddddddddddddddddddddeebddddddddddddddddddddcbbba
abbbcddddddddddddddddddddddddddddddddddddddddddddddddebbdddddddddddddddddddcbbba
abbbdddddddddddddddddddddddddddddddddddddddddddddddddebbddddddddddddddddddddbbba
abbbdddddddddddddddddddddddddddddddddddddddddddddddddeebbdddddddddddddddddddcbba
abbbdddddddddddddddddddddddddddddddddddddddddddddddddeebeeddddddddddddddddddcbba
abbbddddddddddddddddddddddddddddddddddddddddddddddddddeebeedddddddddddddddddcbba
abbbbdddddddddddddddddddddddddddddddddddddddddddddddddeebbeddddddddddddddddddbba
abccccdddddddddddddddddddddddddddddddddddddddddddddddddddbeeddddddddddddddddddba
abbbbbcddddddddddddddddddddddddddddddddddddddddddddddddddbddddddddddddddddddddba
abbbbbcdddddddddddddddddddddddddddddddddddddddddddddddddddbdddddddddddddddddddba
abbbccccddddddddddddddddddddddddddddddddddddddddddddddddddbdddddddddddddddddddba
abbbbbcbbddddddddddddddddddddddddddeeddddddddddddddddddddddddddddddddddddddddbba
abbbbbcbbcdddddddddddddddddddddddddeeeeeeddddddddddddddddddddddddddddddddddddcba
abbbbbbbbcddddddddddddddddddddddddddeeeeeedddddddddddddddddddddddddddddddddddbba
abbbbbbbbcddddddddddddddddddddddddddeebbbeedddddddddddddddddddddddddddddddddcbba
abbbbbbbbcbdddddddddddddddddddddddddeebbbbedddddddddddddddddddddddddddddddddcbba
abbbbbbbbcbbbbddddddddddddddddddddddddebbeeddddddddddddddddddddddddddddddddbcbba
abbbbbbbcccccccdddddddddddddddddddddddeebbeddddddddddddddddddddddddddddddddccbba
abbbbbbbbcbbbcddddddddddddddddddddddddeeeeeddddddddddddddddddddddddddddddddcccba
abbbbbbbbcbbbcbdddddddddddddddddddddddeeeeeedddddddddddddddddddddddddddddddbcbba
abbbbbbbbcbbbcbdddddddddddddddddddddddddeeeeeddddddddddddddddddddddddddddddbcbba
abbbbbbbbcbbbcbbbbddddddddddddddddddddddeeeeedddddddddddddddddddddddddddddbbbbba
abbbbbbbccbbbbbbbbcdddddddddddddddddddddeeeeedddddddddddddddddddddddddddddbbbbba
abbbbbbbbccccccccccdddddddddddddddddddddddeeedddddddddddddddddddddddddddddbbbbba
abbbbbbbbbbbcbbcbbcdddddddddddddddddddddddeeedddddddddddddddddddddddddddddcbbbba
abbbbbbbbbbbcbbcbbdddddddddddddddddddddddddeedddddddddddddddddddddddddddddccccba
abbbbbbbbbbbcbbddddddddddddddddddddddddddddeedddddddddddddddddddddddddddddcbbbba
abbbbbbbbbbbcbbddddddddddddddddddddddddddddeeddddddddddddddddddddddddddddddbbbba
abbbbbbbbbbbcbbddddddddddddddddddddddddddddeeddddddddddddddddddddddddddddddcbbba
abbbbbbcbbbbcbbdddddddddddddddddddddddddddddeddddddddddddddddddddddddddddddcccca
abbbbbbcbbbbcdddddddddddddddddddddddddddddddedddddddddddddddddddddddddddddddbbba
abbbbccccccccdddddddddddddddddddddddddddddddedddddddddddddddddddddddddddddddbbba
abbbccccccccdddddddddddddddddddddddddddddddddddddddddddddddddddddddddddddddddbba
abbbbbbcbbbddddddddddddddddddddddddddddddddddddddddddddddddddddddddddddddddddbba
abbbbbbcbbbddddddddddddddddddddddddddddddddddddddddddddddddddddddddddddddddcccba
abbbbbbcbbdddddddddddddddddddddddddddddddddddddddddddddddddddddddddddddddddcbbba
abbbbbbcbbdddddddddddddddddddddddddddddddddddddddddddddddddddddddddddddddddcbbba
abbbbcccccdddddddddddddddddddddddddddddddddddddddddddddddddddddddddddddddddbbbba
abbbbbbbbbddddddddddddddddddddddddddddddddddddddeeddddddddddddddddddddddddcbbbba
abbbbbbbbbbddddddddddddddddddddddddddddddddddddddeeeeeddddddddddddddddddddcbbbba
abbbbbbbbbbbddddddddddddddddddddddddddddddddddddddebbedddddddddddddddddddbbbbbba
abbbbbbbbbccddddddddddddddddddddddddddddddddddddddeebbeedddddddddddddddcccccbbba
abbbbbbbbbbcdddddddddddddddddddddddddddddddddddddddebbbeddddddddddddddbbcbbbbbba
abbbbbbbcccccdddddddddddddddddddddddddddddddddddddddeeeeeddddddddddddcbbbbbbbbba
abbbbbbbbbbcbbbbdddddddddddddddddddddddddddddddddddddddeeedddddddddddcbbbbbbbbba
abbbbbbbbbbcbbbbbcddddddddddcddddddddddddddddddddddddddeeedddddddddddccccbbbbbba
abbbbbbbbbbbbbbbccccccbbbccccccddddddddddddddddddddddddddddddddddddddcbbbbbbbbba
abbbbbbbbbbbbbbbbcbbbbbbbcbbcbbbbbcccbddddddddddddddddddddddddddddddbcbbbbbbbbba
abbbbbbbbbbbbbbbbcbbbbbbbcbbcbbbbbbbcccccccdddddddddddddddddddddddddbcbbbbbbbbba
abbbbbbbbbbbbbbbbcbbbbbbbbbbcbbbbbbbcbbbbcbbdddddcddddddddddddccccdbbcbbbbbbbbba
abbbbbbbbbbbbbbbbcbbbbbbbbbbbbbbbbbbcbbbbcbbbbddcccccddddddbbbbcbbbbbcbbbbbbbbba
abbbbbbbbbbbbbbbbbbbbbbbbbbbbbbbbbbbbbbbbcbbbbbbbcbbcbbbbbbbbbbbbbbbbbbbbbbbbbba
abbbbbbbbbbbbbbbbbbbbbbbbbbbbbbbbbbbbbbbbbbbbbbbbcbbbbbbbbbbbbbbbbbbbbbbbbbbbbba
abbbbbbbbbbbbbbbbbbbbbbbbbbbbbbbbbbbbbbbbbbbbbbbbbbbbbbbbbbbbbbbbbbbbbbbbbbbbbba
aaaaaaaaaaaaaaaaaaaaaaaaaaaaaaaaaaaaaaaaaaaaaaaaaaaaaaaaaaaaaaaaaaaaaaaaaaaaaaaa
"}
