"a" = (/turf/template_noop,/area/template_noop)
"g" = (/turf/simulated/floor/outdoors/sidewalk/muriki{icon_state = "slab"},/area/submap/outpost21/yard_generic)
"Z" = (/turf/template_noop,/area/submap/outpost21/yard_generic)

(1,1,1) = {"
aaaaaaa
agZggZa
aaaaaaa
"}
